{
  "terrains": [
    { "name": "Grass", "color": { "r": 31, "g": 138, "b": 19 } },
    { "name": "Sand", "color": { "r": 237, "g": 201, "b": 175 } },
    { "name": "Stone", "color": { "r": 128, "g": 128, "b": 128 } }
  ],
  "tiles": [
    { "x": 0, "y": 0, "h": 2, "t": 0 },
    { "x": 0, "y": 1, "h": 2, "t": 0 },
    { "x": 0, "y": 2, "h": 1, "t": 1, "w": 1.9 },
    { "x": 0, "y": 3, "h": 2, "t": 0 },
    { "x": 1, "y": 0, "h": 2, "t": 0 },
    { "x": 1, "y": 1, "h": 1, "t": 1, "w": 1.9 },
    { "x": 1, "y": 2, "h": 1, "t": 1, "w": 1.9 },
    { "x": 1, "y": 3, "h": 2, "t": 0 },
    { "x": 1, "y": 4, "h": 6, "t": 2 },
    { "x": 2, "y": 0, "h": 2, "t": 0 },
    { "x": 2, "y": 1, "h": 1, "t": 1, "w": 1.9 },
    { "x": 2, "y": 2, "h": 2, "t": 0 },
    { "x": 2, "y": 3, "h": 2, "t": 0 },
    { "x": 2, "y": 4, "h": 6, "t": 2 },
    { "x": 2, "y": 5, "h": 9, "t": 2 },
    { "x": 3, "y": 0, "h": 2, "t": 0 },
    { "x": 3, "y": 1, "h": 1, "t": 1, "w": 1.9 },
    { "x": 3, "y": 2, "h": 2, "t": 0 },
    { "x": 3, "y": 3, "h": 2, "t": 0 },
    { "x": 3, "y": 4, "h": 5, "t": 2 },
    { "x": 3, "y": 5, "h": 7, "t": 2 },
    { "x": 3, "y": 6, "h": 12, "t": 2 },
    { "x": 4, "y": 1, "h": 1, "t": 1, "w": 1.9 },
    { "x": 4, "y": 2, "h": 2, "t": 0 },
    { "x": 4, "y": 3, "h": 2, "t": 0 },
    { "x": 4, "y": 4, "h": 3, "t": 0 },
    { "x": 4, "y": 5, "h": 8, "t": 2 },
    { "x": 4, "y": 6, "h": 12, "t": 2 },
    { "x": 5, "y": 2, "h": 2, "t": 0 },
    { "x": 5, "y": 3, "h": 2, "t": 0 },
    { "x": 5, "y": 4, "h": 3, "t": 0 },
    { "x": 5, "y": 5, "h": 9, "t": 2 },
    { "x": 5, "y": 6, "h": 12, "t": 2 },
    { "x": 6, "y": 3, "h": 2, "t": 0 },
    { "x": 6, "y": 4, "h": 5, "t": 2 },
    { "x": 6, "y": 5, "h": 12, "t": 2 },
    { "x": 6, "y": 6, "h": 12, "t": 2 }
  ]
}
